{
    "labyrinth1": [
        ["500","002","500","500","500","500","500","500","500","500","500","022","500","500","500","500","500","500","500","500","500","500","500","500","500"],
        ["500","004","010","010","008","008","008","008","008","500","500","023","500","500","500","008","008","500","500","008","008","008","008","008","500"],
        ["500","003","500","500","010","500","500","500","008","008","008","024","500","500","008","500","008","500","008","008","500","500","500","008","500"],
        ["500","000","500","501","008","000","000","500","008","500","500","024","008","008","008","500","008","500","008","500","500","008","500","008","500"],
        ["500","002","500","008","502","503","000","500","008","500","008","024","500","500","008","500","008","008","008","500","500","008","500","008","500"],
        ["500","003","500","016","505","504","500","500","008","500","008","008","500","500","008","500","500","500","008","500","008","008","500","008","500"],
        ["500","002","500","015","008","008","008","008","008","500","008","008","008","008","008","500","008","008","008","008","008","500","500","500","500"],
        ["500","004","500","500","008","500","500","000","500","500","008","500","500","008","500","500","008","500","500","500","500","500","500","008","500"],
        ["500","003","010","010","008","500","000","008","008","008","008","008","008","008","008","008","008","008","008","008","008","008","008","008","500"],
        ["500","000","500","500","500","500","500","500","500","500","500","500","500","500","500","500","500","500","500","500","500","500","500","500","500"]
    ]
}